p_i	h
i_p	h
p_paix	h
paix_p	h
p_u	h
u_p	h
or_p	h
t_i	h
i_t	h
t_paix	h
paix_t	h
t_u	h
u_t	h
or_t	h
k_i	h
i_k	h
k_paix	h
paix_k	h
k_u	h
u_k	h
or_k	h
b_i	h
i_b	h
b_paix	h
paix_b	h
b_u	h
u_b	h
or_b	h
d_i	h
i_d	h
d_paix	h
paix_d	h
d_u	h
u_d	h
or_d	h
g_i	h
i_g	h
g_paix	h
paix_g	h
g_u	h
u_g	h
or_g	h
l_i	h
i_l	h
l_paix	h
paix_l	h
l_u	h
u_l	h
or_l	h
r_i	h
i_r	h
r_paix	h
paix_r	h
r_u	h
u_r	h
or_r	h
huit_i	h
huit_paix	h
huit_u	h
i_agneau	h
paix_agneau	h
u_agneau	h
or_agneau	h
f_a	h
a_f	h
f_o	h
o_f	h
f_schwa	h
schwa_f	h
f_y	h
y_f	s
f_eux	s
eux_f	s
fe	s
oeuf_f	s
s_a	s
a_s	s
s_o	s
o_s	s
s_schwa	s
schwa_s	s
s_y	s
y_s	s
s_eux	s
eux_s	s
se	s
oeuf_s	s
j_a	s
a_j	s
j_o	s
o_j	s
j_schwa	s
schwa_j	s
j_y	s
y_j	s
j_eux	s
eux_j	s
je	s
oeuf_j	s
m_a	s
a_m	s
m_o	s
o_m	s
m_schwa	s
schwa_m	s
m_y	s
y_m	s
m_eux	s
eux_m	s
me	s
oeuf_m	s
f_on	s
s_on	s
j_on	s
m_on	s
f_on	s
s_on	s
j_on	s
f_hein	s
s_hein	s
j_hein	s
m_hein	s
f_hein	s
s_hein	s
j_hein	s
f_gant	s
s_gant	s
j_gant	s
m_gant	s
f_gant	s
s_gant	s
j_gant	s
f_un	s
s_un	s
j_un	s
m_un	s
f_un	s
s_un	s
j_un	s
